#########################################################################################################################
#      FFFFF                                                                                                            #
#      FFFFF                2                                        FFFFFFFFFFFFFFFFFFFFFFFFFFFFFFFFFFFFFFFFFFFFF   FFF#
#      FFFFF                                                         FFFFFFFFFFFFFFFFFFFFFFFFFFFFFFFFFFFFFFFFFFFFF   FFF#
#                                                R                   FFFFFFFFFFFFFFFFFFFFFFFFFFFFFFFFFFFFFFFFFFFFF   FFF#
#                                                                    FFFFFFFFFFFFFFFFFFFFFFFFFFFFFFFFFFFFFFFFFFFFF   FFF#
#                                                                    FFFFFFFFFFFFFFFFFFFFFFFFFFFFFFFFFFFFFFFFFFFFF   FFF#
#       O               M         M                                  FFFFFFFFFFFFFFFFFFFFFFFFFFFFFFFFFFFFFFFFFFFFF   FFF#
#                                                                    FFFFFFFFFFFFFFFFFFFFFFFFFFFFFFFFFFFFFFFFFFFFF   FFF#
#                                                                    FFFFF         FFFFFFFFFFFFFFFFFFFFFFFFFFFFFFF   FFF#
#                                                                    FFFFF444444444FFFFFFFFFFFFFFFFFFFFFFFFFFFFFFF   FFF#
#                                                                    FFFFF444444444FFFFFFFFFFFFFFFFFFFFFFFFFFFFFFF   FFF#
#                                                                    FFFFF 2       CCCCCCCCCCCCCCFFFFFFFFFFFFFFFFF   FFF#
#                                                                    FFFFF 2       CCCCCCCCCCCCCCFFFFFFFFFFFFFFFFF   FFF#
#                                                                    FFFFF 2     2 FFFFFFFFFFFCCCFFFFFFFFFFFFFFFFF   FFF#
#                                                                    FFFFF 2     2 FFFFFFFFFFCCCFFFFFFFFFFFFFFFFFF   FFF#
#       O               O                              CCCCC         FFFFF 2     2 FFFFFFFFFFFCCCFFFFFFFFFFFFFFFFF   FFF#
#                                        2             CCCCC         FFFFF 2     2 FFFFFFFFFFFCCCFFFFFFFFFFFFFFFFF   FFF#
#                                                      CCCCC         FFFFF 2     2 FFFFFFFFFFFCCCFFFFFFFFFFFFFFFFF   FFF#
#  2                                                   CCCCC         FFFFF 2     2 FFFFFFFFF        FFFFFFFFFFFFFF   FFF#
#******************************************************CCCCC*********FFFFF       2 FFFFFF33333CCC                    FFF#
#                                                      CCCCC         FFFFF 3333333 FFFFFF33333CCC                    FFF#
#                                                      CCCCC       4 FFFFF 3333333 FFFFFFFFF        FFFFFFFFFFFFFF   FFF#
#                                                      CCCCC         FFFFF333333333FFFFFFFFFFFCCCFFFFFFFFFFFFFFFFF   FFF#
#                                 2                    CCCCC   3     FFFFFFFFFFFFFFFFFFFFFFFFFCCCFFFFFFFFFFFFFFFFFFFFFFF#
#                                                      CCCCC         FFFFFFFFFFFFFFFFFFFFFFFFFCCCFFFFFFFFFFFFFFFFFFFFFFF#
#    2                                         3       CCCCC    5    FFFFFFFFFFFFFFFFFFFFFFFFFCCCFFFFFFFFFFFFFFFFFFFFFFF#
#                                                      CCCCC         FFFFFFFFFFFFFFFFFFFFFFFFFCCCFFFFFFFFFFFFFFFFFFFFFFF#
#                                                      CCCCCCCCCCCCCCCCCCCCCCCCCCCCCCCCCCCCCCCCCCCCCCCCCCCCCCCCCCCCCCCCC#
#K      K      K      K      K     K     K     K       CCCCC      K      K      K      K      K      K      K      K    #
#                                                      CCCCC                                                            #
#2 2 2 2 2 2 2 2 2 2 2 2 2 2 2 2 2 2 2 2 2 2 2 2 2 2 2 CCCCC     2 2 2 2 2 2 2 2 2 2 2 2 2 2 2 2 2 2 2 2 2 2 2 2 2 2 2  #
#                                                      CCCCC                                                            #
#                                                      CCCCC                                                            #
#                                                      CCCCC                                                            #
#FFFFFFFFFFFFFFFFFFFFFFFFFFFFFFFFFFFFFFFFFFFFFFFFFFFFFFCCCCCCCEEEEEEEEEEEEEEEEEEEEEEEEEEEEEEEEEEEEEEECCCCCCEEEEEEEEEEEEE#
#FFFFFFFFFFFFFFFFFFFFFFFFFFFFFFFFFFFFFFFFFFFFFFFFFFFFFFCCCCCCCEEEEEEEEEEEEEEEEEEEEEEEEEEEEEEEEEEEEEEECCCCCCEEEEEEEEEEEEE#
#   F             FFFFFFFFFFFFFFFFFFFFFFFFFFFFFFFFFFFFFCCCCCCCEEEEEEEEEEEEEEEEEEEEEEEEEEEEEEEEEEEEEEECCCCCCEEEEEEEEEEEEE#
# Z     M         FFFFFFFFFFFFFFFFFFFFFFFFFFFFFFFFFFFFFCCCCCCCEEEEEEEEEEEEEEEEEEEEEEEEEEEEEEEEEEEEEEECCCCCCEEEEEEEEEEEEE#
#                 FFFFFFFFFFFFFFFFFFFFFFFFFFFFFFFFFFFFFCCCCCCCEEEEEEEEEEEEEEEEEEEEEEEEEEEEEEEEEEEEEEECCCCCCEEEEEEEEEEEEE#
#  F              FFFFFFFFFFFFFFFFFFFFFFFFFFFFFFFFFFFFFCCCCCCCEEEEEEEEEEEEEEEEEEEEEEEEEEEEEEEEEEEEEEECCCCCCEEEEEEEEEEEEE#
#  F              FFFFFFFFFFFFFFFFFFFFFFFFFFFFFFFFFFFFFCCCCCCCEEEEEEEEEEEEEEEEEEEEEEEEEEEEEEEEEEEEEEECCCCCCEEEEEEEEEEEEE#
#  F              FFFFFFFFFFFFFFFFFFFFFFFFFFFFFFFFFFFFFCCCCCCCEEEEEEEEEEEEEEEEEEEEEEEEEEEEEEEEEEEEEEECCCCCCEEEEEEEEEEEEE#
#FFFFFFCCCFFFFFFFFFFFFFFFFFFFFFFFFFFFFFFFFFFFFFFFFFFFFFCCCCCCCEEEEEEEEEEEEEEEEEEEEEEEEEEEEEEEEEEEEEEECCCCCCEEEEEEEEEEEEE#
#FFFFFFCCCFFFFFFFFFFFFFFFFFFFFFFFFFFFFFFFFFFFFFFFFFFFFFCCCCCCCEEEEEEEEEEEEEEEEEEEEEEEEEEEEEEEEEEEEEEECCCCCCEEEEEEEEEEEEE#
#VVVVVVCCCVVVVVVVVVVVVVVVVVVVVVVVVVVVVVVVVVVVWWWWWWWWWWWWWWWWWWWWWWW1WWWWWCCCCCCCCCCCCCCCCCCCCCCCCCCCCCCCCCCCCCCCCCCCCCC#
#   X                                       VWWWWWWWWWWWW1WWWWWWWWWWWWWWWWCCCCCCCCCCCCCCCCCCCCCCCCCCCCCCCCCCCCCCCCCCCCCC#
#           M     FFFFFFFFFFFFFFFFFF        VWWWWWWWWWWWWWWWWWWWWWWWWWWWWWCCCCCCCCCCCCCCCCCCCCCCCCCCCCCCCCCCCCCCCCCCCCCC#
#   M       CCCCCCCCCCCC                    VWWWWWWWWWWWWWWWWWWWWWWWWWWWWWCCCCCCCCCCCCCCCCCCCCCCCCCCCCCCCCCCCCCCCCCCCCCC#
#   CCCCCCCCC          C               CCCCCC P       P     P    P        CCCCCCCCCCCCCCCCCCCBCCCCCCCCCCCCCCCCCCCCCCCCCC#
#           CC         CCCCCCCCCCCCCCCCCCCCCC                             CCCCCCCCCCCCCCCCCCCCCCCCCCCCCCCCCCCCCCCCCCCCCC#
#            C             C           CCCCCV                             CCCCCCCCCCCCCCCCCCCCCCCCCCCCCCCCCCCCCCCCCCCCCC#
#            M         X   C                VWWWWWWWWWWWWWWWWWWWWWWWWWWWWWEEEEEEEEEEEEEEEEEECCCEEEEEEEEEEEEEEEEEEEEEEEEE#
#                          C       p        VWWWWWW1WWWWWWWWWWWWWWWWWWWWWWEEEEEEEEEEEEEEEEEECCCEEEEEEEEEEEEEEEEEEEEEEEEE#
#   X                      C                VWW1WWWWWWWWWWW1WWWWWWWWWW1WWWEEEEEEEEEEEEEEEEEECCCEEEEEEEEEEEEEEEEEEEEEEEEE#
#       Z             MCCCCC             T  VWWWWWWWWWWWWWWWWWWWWWWWWWWWWWEEEEEEEEEEEEEEEEEECCCEEEEEEEEEEEEEEEEEEEEEEEEE#
#           X         C                     VFFFFFFFFFFWWWWWWWEEEEEEEEEEEEEEEEEEEEEEEEEEEEEECCCEEEEEEEEEEEEEEEEEEEEEEEEE#
#VVVVVVVVVVVVVVVVVVVVVCCCVVVVVVVVVVVVVVVVVVVVFFFFFFFFFFFWWWWWWEEEEEEEEEEEEEEEEEEEEEEEEEEEEEECCCEEEEEEEEEEEEEEEEEEEEEEEEE#
#FFFFFFFFFFFFFFFFFFFFFCCCFFFFFFFFFFFFFFFFFFFFFFFFFFFFFFFWWWWWWEEEEEEEEEEEEEEEEEEEEEEEEEEEEEECCCEEEEEEEEEEEEEEEEEEEEEEEEE#
#FFFFFFFFFFFFFFFFFFFFFCCCFFFFFFFFFFFFFFFFFFFFFFFFFFFFFFFWW1WWWEEEEEEEEEEEEEEEEEEEEEEEEEEEEEECCCEEEEEEEEEEEEEEEEEEEEEEEEE#
#FFFFFFFFFFFFFFFFFFFFFCCCFFFFFFFFFFFFFFFFFFFFFFFFFFFFFFFWWWWWW                              CCC                         #
#FFFFFFFFFFFFFFFFFFFFFCCCFFFFFFFFFFFFFFFFFFFFFFFFFFFFFFFWWW1WW                              CCC                         #
#FFFFFFFFFFFFFFFFFFFFFCCCFFFFFFFFFFFFFFFFFFFFFFFFFFFFFFFWWWWWW                              CCC                         #
#FFFFFFFFFFFFFFFFFFFFFCCCFFFFFFFFFFFFFFFFFFFFFFFFFFFFFFFWWWWWW                              CCC                         #
#**p****p****p****p****p****p***p****p****p****p****p***WWW1WWp****p****p****p*****p****p********p*****p****p****p******#
#                                                        WWWWW                                                          #
#                                                        WWWWW                                                          #
#                                                        WWWWW                                                          #
#                                                        WWWWW                                                          #
WWWWWWWWWWWWWWWWWWWWWWWWWWWWWWWWWWWWWWWWWWWWWWWWWWWWWWWWWWWWWWWWWWWWWWWWWWWWWWWWWWWWWWWWWWWWWWWWWWWWWWWWWWWWWWWWWWWWWWWWW
WWWWWWWWWWWWWWWWWWWWWWWWWWWWWWWWWWWWWWWWWWWWWWWWWWWWWWWWWWWWWWWWWWWWWWWWWWWWWWWWWWWWWWWWWWWWWWWWWWWWWWWWWWWWWWWWWWWWWWWWW
WWWWWWWWWWWWWWWWWWWWWWWWWWWWWWWWWWWWWWWWWWWWWWWWWWWWWWWWWWWWWWWWWWWWWWWWWWWWWWWWWWWWWWWWWWWWWWWWWWWWWWWWWWWWWWWWWWWWWWWWW
WWWWWWWWWWWWWWWWWWWWWWWWWWWWWWWWWWWWWWWWWWWWWWWWWWWWWWWWWWWWWWWWWWWWWWWWWWWWWWWWWWWWWWWWWWWWWWWWWWWWWWWWWWWWWWWWWWWWWWWWW
WWWWWWWWWWWWWWWWWWWWWWWWWWWWWWWWWWWWWWWWWWWWWWWWWWWWWWWWWWWWWWWWWWWWWWWWWWWWWWWWWWWWWWWWWWWWWWWWWWWWWWWWWWWWWWWWWWWWWWWWW
WWWWWWWWWWWWWWWWWWWWWWWWWWWWWWWWWWWWWWWWWWWWWWWWWWWWWWWWWWWWWWWWWWWWWWWWWWWWWWWWWWWWWWWWWWWWWWWWWWWWWWWWWWWWWWWWWWWWWWWWW
WWWWWWWWWWWWWYWWWWWWWWWWWWWWWWWWWWWWWWWWWWWWWWWWWWWWWWWWWWWWWWWWWWWWWWWWWWWWWWWWWWWWWWWWWWWWWWWWWWWWWWWWWWWWWWWWWWWWWWWWW
WWWWWWWWWWWWWWWWWWWWWWWWWWWWWWWWWWWWWWWWWWWWWWWWWWWWWWWWWWWWWWWWWWWWWWWWWWWWWWWWWWWWWWWWWWWWWWWWWWWWWWWWWWWWWWWWWWWWWWWWW
WWWWWWWWWWWWWWWWWWWWWWWWWWWWWWWWWWWWWWWWWWWWWWWWWWWWWWWWWWWWWWWWWWWWWWWWWWWWWWWWWWWWWWWWWWWWWWWWWWWWWWWWWWWWWWWWWWWWWWWWW
WWWWWWWWWWWWWWWWWWWWWWWWWWWWWWWWWWWWWWWWWWWWWWWWWWWWWWWWWWWWWWWWWWWWWWWWWWWWWWWWWWWWWWWWWWWWWWWWWWWWWWWWWWWWWWWWWWWWWWWWW
WWWWWWWWWWWWWWWWWWWWWWWWWWWWWWWWWWWWWWWWWWWWWWWWWWWWWWWWWWWWWWWWWWWWWWWWWWWWWWWWWWWWWWWWWWWWWWWWWWWWWWWWWWWWWWWWWWWWWWWWW
WWWWWWWWWWWWWWWWWWWWWWWWWWWWWWWWWWWWWWWWWWWWWWWWWWWWWWWWWWWWWWWWWWWWWWWWWWWWWWWWWWWWWWWWWWWWWWWWWWWWWWWWWWWWWWWWWWWWWWWWW
WWWWWWWWWWWWWWWWWWWWWWWWWWWWWWWWWWWWWWWWWWWWWWWWWWWWWWWWWWWWWWWWWWWWWWWWWWWWWWWWWWWWWWWWWWWWWWWWWWWWWWWWWWWWWWWWWWWWWWWWW
WWWWWWWWWWWWWWWWWWWWWWWWWWWWWWWWWWWWWWWWWWWWWWWWWWWWWWWWWWWWWWWWWWWWWWWWWWWWWWWWWWWWWWWWWWWWWWWWWWWWWWWWWWWWWWWWWWWWWWWWW
WWWWWWWWWWWWWWWWWWWWWWWWWWWWWWWWWWWWWWWWWWWWWWWWWWWWWWWWWWWWWWWWWWWWWWWWWWWWWWWWWWWWWWWWWWWWWWWWWWWWWWWWWWWWWWWWWWWWWWWWW
WWWWWWWWWWWWWWWWWWWWWWWWWWWWWWWWWWWWWWWWWWWWWWWWWWWWWWWWWWWWWWWWWWWWWWWWWWWWWWWWWWWWWWWWWWWWWWWWWWWWWWWWWWWWWWWWWWWWWWWWW
WWWWWWWWWWWWWWWWWWWWWWWWWWWWWWWWWWWWWWWWWWWWWWWWWWWWWWWWWWWWWWWWWWWWWWWWWWWWWWWWWWWWWWWWWWWWWWWWWWWWWWWWWWWWWWWWWWWWWWWWW
WWWWWWWWWWWWWWWWWWWWWWWWWWWWWWWWWWWWWWWWWWWWWWWWWWWWWWWWWWWWWWWWWWWWWWWWWWWWWWWWWWWWWWWWWWWWWWWWWWWWWWWWWWWWWWWWWWWWWWWWW
WWWWWWWWWWWWWWWWWWWWWWWWWWWWWWWWWWWWWWWWWWWWWWWWWWWWWWWWWWWWWWWWWWWWWWWWWWWWWWWWWWWWWWWWWWWWWWWWWWWWWWWWWWWWWWWWWWWWWWWWW
WWWWWWWWWWWWWWWWWWWWWWWWWWWWWWWWWWWWWWWWWWWWWWWWWWWWWWWWWWWWWWWWWWWWWWWWWWWWWWWWWWWWWWWWWWWWWWWWWWWWWWWWWWWWWWWWWWWWWWWWW
WWWWWWWWWWWWWWWWWWWWWWWWWWWWWWWWWWWWWWWWWWWWWWWWWWWWWWWWWWWWWWWWWWWWWWWWWWWWWWWWWWWWWWWWWWWWWWWWWWWWWWWWWWWWWWWWWWWWWWWWW
WWWWWWWWWWWWWWWWWWWWWWWWWWWWWWWWWWWWWWWWWWWWWWWWWWWWWWWWWWWWWWWWWWWWWWWWWWWWWWWWWWWWWWWWWWWWWWWWWWWWWWWWWWWWWWWWWWWWWWWWW
WWWWWWWWWWWWWWWWWWWWWWWWWWWWWWWWWWWWWWWWWWWWWWWWWWWWWWWWWWWWWWWWWWWWWWWWWWWWWWWWWWWWWWWWWWWWWWWWWWWWWWWWWWWWWWWWWWWWWWWWW
WWWWWWWWWWWWWWWWWWWWWWWWWWWWWWWWWWWWWWWWWWWWWWWWWWWWWWWWWWWWWWWWWWWWWWWWWWWWWWWWWWWWWWWWWWWWWWWWWWWWWWWWWWWWWWWWWWWWWWWWW
WWWWWWWWWWWWWWWWWWWWWWWWWWWWWWWWWWWWWWWWWWWWWWWWWWWWWWWWWWWWWWWWWWWWWWWWWWWWWWWWWWWWWWWWWWWWWWWWWWWWWWWWWWWWWWWWWWWWWWWWW
WWWWWWWWWWWWWWWWWWWWWWWWWWWWWWWWWWWWWWWWWWWWWWWWWWWWWWWWWWWWWWWWWWWWWWWWWWWWWWWWWWWWWWWWWWWWWWWWWWWWWWWWWWWWWWWWWWWWWWWWW
